############
#        O #
#   P   ####
#          #
#######    #
#O   ##    #
#    ##    #
#          #
#      XX  #
#      #   #
############
